22222222222222222
21111111111111112
21000000000000012
21000100000000012
21101000000000012
21000000000000012
21000000000000012
21000000000000312
21000000000000012
21000000000000412
21000000000000012
21000000000000012
21000000000000012
21000000000000612
21000000090807012
21111111111111112
22222222222222222